### Western Europe
GER = "countries/_WestEuropean.txt" # Germany
FRA = "countries/_WestEuropean.txt" # France
SPM = "countries/_WestEuropean.txt" # Spain - Monarchist
SPR = "countries/_WestEuropean.txt" # Spain - Republic
SPA = "countries/_WestEuropean.txt" # Spain - Socialist
SPF = "countries/_WestEuropean.txt" # Spain - Falangist
BEL = "countries/_WestEuropean.txt" # Belgium
RHI = "countries/_WestEuropean.txt" # Rhineland
HOL = "countries/_WestEuropean.txt" # Netherlands
ITA = "countries/_WestEuropean.txt" # Italy
POR = "countries/_WestEuropean.txt" # Portugal
PRR = "countries/_WestEuropean.txt" # Portuguese Republic
SWI = "countries/_WestEuropean.txt" # Switzerland
SWE = "countries/_WestEuropean.txt" # Sweden
AUS = "countries/_WestEuropean.txt" # Austria
ASR = "countries/_WestEuropean.txt" # Austrian Socialist Republic
IRE = "countries/_WestEuropean.txt" # Ireland
KNE = "countries/_WestEuropean.txt" # Dutch Exiles
HUN = "countries/_WestEuropean.txt" # Hungary
HSR = "countries/_WestEuropean.txt" # Hungarian Socialist Republic
SCO = "countries/_WestEuropean.txt" # Scotland
WLS = "countries/_WestEuropean.txt" # Wales
SAX = "countries/_WestEuropean.txt" # Saxony
POM = "countries/_WestEuropean.txt" # Pomerainia
SHO = "countries/_WestEuropean.txt" # Schleswig-Holstein
BRW = "countries/_WestEuropean.txt" # Brandenburg-Westpommern
HAN = "countries/_WestEuropean.txt" # Hannover
ERM = "countries/_WestEuropean.txt" # Ermland
HES = "countries/_WestEuropean.txt" # Hessen
BAW = "countries/_WestEuropean.txt" # Baden-Wurtemberg
BAY = "countries/_WestEuropean.txt" # Bayern
SIL = "countries/_WestEuropean.txt" # Silesia
BRI = "countries/_WestEuropean.txt" # Britanny
OCC = "countries/_WestEuropean.txt" # Occitania
NRM = "countries/_WestEuropean.txt" # Normandy
ORL = "countries/_WestEuropean.txt" # Valkist France
GRP = "countries/_WestEuropean.txt" # German Puppet
NAP = "countries/_WestEuropean.txt" # Naples
SIC = "countries/_WestEuropean.txt" # Sicily
LOM = "countries/_WestEuropean.txt" # Lombardy
PIE = "countries/_WestEuropean.txt" # Piedmont
SRV = "countries/_WestEuropean.txt" # Venice
ITP = "countries/_WestEuropean.txt" # Italian Puppet
COR = "countries/_WestEuropean.txt" # Corsica
SAR = "countries/_WestEuropean.txt" # Sardinia
FLA = "countries/_WestEuropean.txt" # Flanders
WLL = "countries/_WestEuropean.txt" # Wallonia
DEN = "countries/_WestEuropean.txt" # Denmark
ICE = "countries/_WestEuropean.txt" # Iceland
WGR = "countries/_WestEuropean.txt" # West Germany
DDR = "countries/_WestEuropean.txt" # East Germany
FRP = "countries/_WestEuropean.txt" # French Puppet
FIN = "countries/_WestEuropean.txt" # Finland
NOR = "countries/_WestEuropean.txt" # Norway
NIR = "countries/_WestEuropean.txt" # Northern Ireland
FIC = "countries/_WestEuropean.txt" # French Indochina
DEI = "countries/_WestEuropean.txt" # Dutch East Indies

### Eastern European
SOV = "countries/_EastEuropean.txt" # Soviet Union
RUS = "countries/_EastEuropean.txt" # Russian Republic
POL = "countries/_EastEuropean.txt" # Poland
CZE = "countries/_EastEuropean.txt" # Czechoslovakia
LIT = "countries/_EastEuropean.txt" # Lithuania
LAT = "countries/_EastEuropean.txt" # Latvia
EST = "countries/_EastEuropean.txt" # Estonia
ROM = "countries/_EastEuropean.txt" # Romania
YUG = "countries/_EastEuropean.txt" # Yugoslavia
SER = "countries/_EastEuropean.txt" # Serbia
ALB = "countries/_EastEuropean.txt" # Albania
BUL = "countries/_EastEuropean.txt" # Bulgaria
MNT = "countries/_EastEuropean.txt" # Montenegro
GRE = "countries/_EastEuropean.txt" # Greece
BLR = "countries/_EastEuropean.txt" # Belarus
TRA = "countries/_EastEuropean.txt" # Transylvania
CEN = "countries/_EastEuropean.txt" # Centroslavia
BOH = "countries/_EastEuropean.txt" # Bohemia
MRV = "countries/_EastEuropean.txt" # Morovia
SLO = "countries/_EastEuropean.txt" # Slovakia
STD = "countries/_EastEuropean.txt" # Sudetenland
BOS = "countries/_EastEuropean.txt" # Bosnia
VRS = "countries/_EastEuropean.txt" # Valkist Russia
CRO = "countries/_EastEuropean.txt" # Croatia
UKR = "countries/_EastEuropean.txt" # Ukraine
GEO = "countries/_EastEuropean.txt" # Georgia
MOL = "countries/_EastEuropean.txt" # Moldova
UBD = "countries/_EastEuropean.txt" # United Baltic Dutchy
MAC = "countries/_EastEuropean.txt" # Macedonia

### North America
USA = "countries/_WestEuropean.txt" # United States
QUE = "countries/_WestEuropean.txt" # Quebec

### South America
MEX = "countries/_SouthAmerican.txt" # Mexico
BOL = "countries/_SouthAmerican.txt" # Bolivia
BRA = "countries/_SouthAmerican.txt" # Brazil
UBR = "countries/_SouthAmerican.txt" # Brazil - Socialist
BPS = "countries/_SouthAmerican.txt" # Brazil - Reactionary
CHL = "countries/_SouthAmerican.txt" # Chile
COL = "countries/_SouthAmerican.txt" # Colombia
COS = "countries/_SouthAmerican.txt" # Costa Rica
ECU = "countries/_SouthAmerican.txt" # Ecuador
ELS = "countries/_SouthAmerican.txt" # El Salvador
GUA = "countries/_SouthAmerican.txt" # Guatemala
HON = "countries/_SouthAmerican.txt" # Honduras
NIC = "countries/_SouthAmerican.txt" # Nicaragua
PAN = "countries/_SouthAmerican.txt" # Panama
PRU = "countries/_SouthAmerican.txt" # Peru
URG = "countries/_SouthAmerican.txt" # Uruguay
CUB = "countries/_SouthAmerican.txt" # Cuba
DOM = "countries/_SouthAmerican.txt" # Dominican Republic
HAI = "countries/_SouthAmerican.txt" # Haiti
BAH = "countries/_SouthAmerican.txt" # Bahamas
BLZ = "countries/_SouthAmerican.txt" # Belize
JAM = "countries/_SouthAmerican.txt" # Jamaica
GDL = "countries/_SouthAmerican.txt" # Guadaloupe
TRI = "countries/_SouthAmerican.txt" # Trinidad and Tobago
PUE = "countries/_SouthAmerican.txt" # Puerto Rico
BAS = "countries/_SouthAmerican.txt" # British Antilles
ARG = "countries/_SouthAmerican.txt" # Argentina
VEN = "countries/_SouthAmerican.txt" # Venezuela
PAR = "countries/_SouthAmerican.txt" # Paraguay
SUR = "countries/_SouthAmerican.txt" # Suriname
CAY = "countries/_SouthAmerican.txt" # Cayenne

### Central Asia
KAZ = "countries/_MiddleEastern.txt" # Kazakhstan
TRK = "countries/_MiddleEastern.txt" # Turkestan
AZR = "countries/_MiddleEastern.txt" # Azerbaijan
ARM = "countries/_MiddleEastern.txt" # Armenia
UZB = "countries/_MiddleEastern.txt" # Uzbekistan
TAJ = "countries/_MiddleEastern.txt" # Tajikistan
KYR = "countries/_MiddleEastern.txt" # Kyrgyzstan
DAG = "countries/_MiddleEastern.txt" # Dagestan

### Middle East
TUR = "countries/_MiddleEastern.txt" # Turkey
TRT = "countries/_MiddleEastern.txt" # Turkish Revolt
AFG = "countries/_MiddleEastern.txt" # Afghanistan
YEM = "countries/_MiddleEastern.txt" # Yemen
OMA = "countries/_MiddleEastern.txt" # Oman
SAU = "countries/_MiddleEastern.txt" # Saudi Arabia
LEB = "countries/_MiddleEastern.txt" # Lebanon
EGY = "countries/_MiddleEastern.txt" # Egypt
LBA = "countries/_MiddleEastern.txt" # Libya
PAL = "countries/_MiddleEastern.txt" # Palestine
ISR = "countries/_MiddleEastern.txt" # Israel
KUR = "countries/_MiddleEastern.txt" # Kurdestan
ALG = "countries/_MiddleEastern.txt" # Algeria
MOR = "countries/_MiddleEastern.txt" # Morocco
TUN = "countries/_MiddleEastern.txt" # Tunisia
ARB = "countries/_MiddleEastern.txt" # Hashemite Arabia
QAT = "countries/_MiddleEastern.txt" # Qatar
KUW = "countries/_MiddleEastern.txt" # Kuwait
CYP = "countries/_MiddleEastern.txt" # Cyprus
IRQ = "countries/_MiddleEastern.txt" # Iraq
PER = "countries/_MiddleEastern.txt" # Persia
SYR = "countries/_MiddleEastern.txt" # Syria
JOR = "countries/_MiddleEastern.txt" # Jordan
UAE = "countries/_MiddleEastern.txt" # United Arab Emirates

### Asia
PHI = "countries/_Asian.txt" # Philippines
PHR = "countries/_Asian.txt" # Philippine Revolt
SIA = "countries/_Asian.txt" # Siam
JAP = "countries/_Asian.txt" # Japan
ICR = "countries/_Asian.txt" # Indochina
MAN = "countries/_Asian.txt" # Manchuria
ZHI = "countries/_Asian.txt" # Zhili
CHI = "countries/_Asian.txt" # China
SIC = "countries/_Asian.txt" # Sichuan
YUN = "countries/_Asian.txt" # Yunnan
MON = "countries/_Asian.txt" # Mongolia
BHU = "countries/_Asian.txt" # Bhutan
TIB = "countries/_Asian.txt" # Tibet
XSM = "countries/_Asian.txt" # Ma Clique
NEP = "countries/_Asian.txt" # Nepal
SIK = "countries/_Asian.txt" # Xinjiang
KOR = "countries/_Asian.txt" # Korea
VIN = "countries/_Asian.txt" # Vietnam
LAO = "countries/_Asian.txt" # Laos
CAM = "countries/_Asian.txt" # Cambodia
MAL = "countries/_Asian.txt" # Malaysia
INS = "countries/_Asian.txt" # Insulindia
KMT = "countries/_Asian.txt" # Jieshi
GUO = "countries/_Asian.txt" # Yuxiang
GXC = "countries/_Asian.txt" # Zongren
GDC = "countries/_Asian.txt" # Jingwei
SHX = "countries/_Asian.txt" # Shanxi
TAN = "countries/_Asian.txt" # Tannu Tuva
BRM = "countries/_Asian.txt" # Burma
GZC = "countries/_Asian.txt" # ?
SIR = "countries/_Asian.txt" # ?
PNG = "countries/_Asian.txt" # Papua New Guinea

### South Asia
IND = "countries/_Indian.txt" # India
INC = "countries/_Indian.txt" # India - Communist
TRV = "countries/_Indian.txt" # Travancore
MDR = "countries/_Indian.txt" # Madras
HYD = "countries/_Indian.txt" # Hyderabad
ORI = "countries/_Indian.txt" # Orissa
RJH = "countries/_Indian.txt" # Rajahstan
BAL = "countries/_Indian.txt" # Baluchistan
PUN = "countries/_Indian.txt" # Punjab
KAS = "countries/_Indian.txt" # Kashmir
BIH = "countries/_Indian.txt" # Bihar
MYS = "countries/_Indian.txt" # Mysore
BOM = "countries/_Indian.txt" # Bombay
PAK = "countries/_Indian.txt" # Pakistan
BAN = "countries/_Indian.txt" # Bangladesh
SRL = "countries/_Indian.txt" # Sri Lanka

### Commonwealth
ENG = "countries/_Commonwealth.txt" # United Kingdom
ENP = "countries/_Commonwealth.txt" # English Puppet
EGL = "countries/_Commonwealth.txt" # England
UOB = "countries/_Commonwealth.txt" # Union of Britain
AST = "countries/_Commonwealth.txt" # Australia
NZL = "countries/_Commonwealth.txt" # New Zealand
NFL = "countries/_Commonwealth.txt" # Newfoundland
CAN = "countries/_Commonwealth.txt" # Canada
RAJ = "countries/_Commonwealth.txt" # British Raj
SAF = "countries/_Commonwealth.txt" # South Africa
ZAF = "countries/_Commonwealth.txt" # Zuid

### Africa
ANG = "countries/_African.txt" # Angola
MZB = "countries/_African.txt" # Mozambique
COG = "countries/_African.txt" # Congo
KEN = "countries/_African.txt" # Kenya
ZIM = "countries/_African.txt" # Zimbabwe
BOT = "countries/_African.txt" # Botswana
SUD = "countries/_African.txt" # Sudan
SOM = "countries/_African.txt" # Somalia
NIG = "countries/_African.txt" # Nigeria
RHO = "countries/_African.txt" # Rhodesia
TAU = "countries/_African.txt" # Taureg
ERI = "countries/_African.txt" # Eritrea
NFA = "countries/_African.txt" # French North Africa
NFQ = "countries/_African.txt" # French Central Africa
MAD = "countries/_African.txt" # Madagascar
DJI = "countries/_African.txt" # Djibouti
UGA = "countries/_African.txt" # Uganda
RWA = "countries/_African.txt" # Rwanda
BRD = "countries/_African.txt" # Burundi
TZN = "countries/_African.txt" # Tanzania
ZAM = "countries/_African.txt" # Zambia
MLW = "countries/_African.txt" # Malawi
GAB = "countries/_African.txt" # Gabon
RCG = "countries/_African.txt" # Republic of Congo
EQG = "countries/_African.txt" # Equatorial Guinea
CMR = "countries/_African.txt" # Cameroon
CAR = "countries/_African.txt" # Central African Republic
CHA = "countries/_African.txt" # Chad
NGA = "countries/_African.txt" # Nigeria
DAH = "countries/_African.txt" # Dahomey
TOG = "countries/_African.txt" # Togo
GHA = "countries/_African.txt" # Ghana
IVO = "countries/_African.txt" # Ivory Coast
VOL = "countries/_African.txt" # Upper Volta
MLI = "countries/_African.txt" # Mali
SIE = "countries/_African.txt" # Sierra Leone
GNA = "countries/_African.txt" # Guinea
GNB = "countries/_African.txt" # Guinea-Bissau
SEN = "countries/_African.txt" # Senegal
GAM = "countries/_African.txt" # Gambia
NGR = "countries/_African.txt" # Niger
NMB = "countries/_African.txt" # Namibia
WES = "countries/_African.txt" # Western Sahara

### Ocenia
FIJ = "countries/_Indian.txt" # Fiji
